NO ./img/bluestone.png
SO ./img/colorstone.png		
WE ./img/eagle.png
EA ./img/greystone.png
   F	   	12,00,223




C 200,30,255

1111111111111111111111111111111111111
        10N00000011000000000011 1
        101100000111000000000001 1
        1001000000000000000000111
111111111011000001110000000000001
100000000011000001110111111111111
11110111111111011100000010001        1
11110111111111011101010010001       101
11000000110101011100000010001        1
10000000000000001100000010001
10000000000000001101010010001
1100000111010101111101111000111
11110111 1110101 1011110100001
11111111 1111111 1111111111111
			    1