NO ./img/bluestone.png
SO ./img/colorstone.png		
WE ./img/eagle.png
EA ./img/greystone.png
   F	   	12,00,223




C 200,30,255

11111111111111111
10000000000000001
10000110000000001
10000000000000001
10000000N00000001
10000000000000001
10000000000000001
10000000000000001
11111111111111111