NO ./img/mario/brick_mario.xpm
SO ./img/mario/interrogation_point_mario.xpm	
WE ./img/mario/mario_pipe.xpm
EA ./img/mario/mario_mushroom.xpm
DO ./img/mario/tileset_dungeon_PNG.xpm
CO ./img/mario/coin_mario.xpm

   F	   	0,200,0




C 0,128,255

11111111111111111
10000010000C00001
10000010000000101
10000000W00000001
11111111D11111111
10101000000000101
10000000000000101
11111111111111111