NO ./img/bluestone.png
SO ./img/colorstone.png		
WE ./img/eagle.png
EA ./img/greystone.png
   F	   	12,00,223




C 200,30,255

11111111111111111
10000001000000001
10000000000001001
10001010001000001
10000000N00000011
10000001000000101
10000000000000101
11111111111111111