NO ./img/mario/brick_mario.xpm
SO ./img/mario/interrogation_point_mario.xpm	
WE ./img/mario/mario_pipe.xpm
EA ./img/mario/mario_mushroom.xpm
   F	   	255,0,255




C 0,128,255

111111111111111111111111
100000100000000001000001
100000100000000000000001
10000000000000000000E001
111111110111111110111111
101010000000001000101011
111111111111111111111111