NO ./img/mario/brick_mario.xpm
SO ./img/mario/interrogation_point_mario.xpm	
WE ./img/mario/mario_pipe.xpm
EA ./img/mario/mario_mushroom.xpm
DO ./img/mario/mario_mushroom.xpm
   F	   	0,200,0




C 0,128,255

1
1
1
111111111111       1
10000000N01
111111110111       1
1      101   1
11111111111111111
1










